R 500 500
NO ./textures/wood.xpm

SO ./textures/metal.xpm

C 0,55,255

WE ./textures/grass.xpm
EA ./textures/brick.xpm
F 200,200,0
S ./textures/tonneau.xpm

1111111111111111
122220000000000111
12222000000000000000000001
1000000000000001111111111
1001200000000W01
100000000000000111
1000000000000001
1111111011110111111111111111111111111111111111111111111111111111
1111111000110111111111111111111111111111111111111111111111111111
111111101000111111111111111111111111111111111111
111111111111111111111111111111