R 600 500
NO ./textures/wood.xpm

SO ./textures/metal.xpm

C 0,55,255

WE ./textures/grass.xpm
EA ./textures/brick.xpm
F 139,69,19
S ./textures/tonneau.xpm

1111111111111111
1222200000000001
1222200000000001
1000000000000001
1000000000000001
1000000000000001
10N0000000000001
1111111111111111
