R 500 500

NO ./textures/wood.xpm

SO ./textures/metal.xpm

C 0,55,50

WE ./textures/brick.xpm
EA ./textures/grass.xpm
F 255,0,0

S ./textures/tonneau.xpm

1111111111111111
1222200000000001
100000000000011
1001200000000001
10000000000000011111
10000000000000000001
10000000000000011111
1000000000000001
1000000000000001
100W000000000001
1111111111111111