R 1024 860
NO ./textures/wood.xpm

SO ./textures/metal.xpm

C 0,55,255

WE ./textures/grass.xpm
EA ./textures/brick.xpm
F 200,200,200
S ./textures/tonneau.xpm

1111111111111111
1222200000000001111111111
12222000000000000000000001
1000000000000001111111111
1001200000000W01
100000000000000111
100000000000000    1
1111111011110111111111111111111111111111111111111111111111111111
1111111000110111111111111111111111111111111111111111111111111111
111111101000111111111111111111111111111111111111
111111111111111111111111111111