R 500 500
NO ./textures/wood.xpm

SO ./textures/metal.xpm

C 0,0,255

WE ./textures/grass.xpm
EA ./textures/brick.xpm
F 150,150,150
S ./textures/tonneau.xpm


11111111111111111111111111111
120000000000000000000000011111
100000000000000000111000100001
10000002000000000000000W001111
1000000000000000000000000111111111
 1110000000000000000000000020000001
1100200000000011000000000000111111
11000000000001111000000000001
100000000000111000000000000011
110000000000111000000000001111
110000000001111000000000000111
111111111111111111111111111111
