R 600 655
NO ./textures/wood.xpm

SO ./textures/metal.xpm

C 53,55,150

WE ./textures/grass.xpm
EA ./textures/brick.xpm
F 150,150,150
S ./textures/tonneau.xpm

111111111111111111111111111111
120000000000000000000000011111
100000000000000000111000100001
10N000020000000000000000001111
1000000000000000000000000111111
1000000000000000000000020000001
110020000000001100000000000011
110000000000011110000000000011
100000000000111000000000000011
110000000000111000000000001111
110000000001111000000000000111
111111111111111111111111111111