R 600   500

NO ./textures/brick.xpm
SO ./textures/wood.xpm

C 0,55,50

WE ./textures/wood.xpm

EA ./textures/snow_tile.xpm
F 255,0,0

S ./textures/tonneau.xpm

1111111111111111
1222200000000001
100000000111111
1001200000000001
10000000000000011111
10000000000000000001
10000000000000011111
1000002222222201
1000002222222201
100E0022222222001
1111111111111111
