R 600 500
NO ./textures/wood.xpm

SO ./textures/metal.xpm

C 0,55,255

WE ./textures/grass.xpm
EA ./textures/brick.xpm
F 139,69,19
S ./textures/tonneau.xpm

111111
122221
122221
100001
100001
100001
10N001
111111
